Name Map1
FileName Map1
Size 20:20
Blocks
1 1 1 1 1 1 1 1 1 1 1 1 1 1 1 1 1 1 1 1 
1 1 1 1 1 1 1 1 1 1 1 1 1 1 1 1 1 1 1 1 
1 2 2 2 2 1 2 1 1 1 1 1 1 1 1 1 1 1 1 1 
1 2 1 1 2 1 2 2 2 2 1 1 1 1 1 1 1 1 1 1 
1 2 1 2 2 1 2 1 1 1 1 1 1 1 1 1 1 1 1 1 
1 1 1 1 1 1 1 1 1 1 1 1 1 1 1 1 1 1 1 1 
1 2 2 2 2 1 2 2 2 2 1 1 1 1 1 1 1 1 1 1 
1 1 1 1 2 1 2 2 1 2 1 1 1 1 1 1 1 1 1 1 
1 2 2 2 2 1 1 1 1 1 1 1 1 1 1 1 1 1 1 1 
1 1 1 1 1 1 2 2 1 2 1 1 1 1 1 1 1 1 1 1 
1 2 2 2 2 1 2 2 2 2 1 1 1 1 1 1 1 1 1 1 
1 1 1 2 1 1 1 1 1 1 1 1 1 1 1 1 1 1 1 1 
1 1 2 1 1 1 2 1 1 1 1 1 1 1 1 1 1 1 1 1 
1 2 2 2 2 1 2 2 2 2 1 1 1 1 1 1 1 1 1 1 
1 1 1 1 1 1 2 1 1 1 1 1 1 1 1 1 1 1 1 1 
1 1 1 1 1 1 1 1 1 1 1 1 1 1 1 1 1 1 1 1 
1 1 1 1 1 1 1 1 1 1 1 1 1 1 1 1 1 1 1 1 
1 1 1 1 1 1 1 1 1 1 1 1 1 1 1 1 1 1 1 1 
1 1 1 1 1 1 1 1 1 1 1 1 1 1 1 1 1 1 1 1 
1 1 1 1 1 1 1 1 1 1 1 1 1 1 1 1 1 1 1 1 
