Name Map
FileName start
Size 20:20
Blocks
1 1 1 1 2 2 2 1 1 1 1 1 1 1 1 1 1 1 1 1 
1 1 2 1 1 2 2 2 1 1 1 1 1 1 1 1 1 1 1 1 
1 1 2 2 1 1 2 2 2 1 1 1 1 1 1 1 1 1 1 1 
2 1 2 2 2 1 1 2 2 2 1 1 1 1 1 1 1 1 1 1 
2 1 2 2 2 1 1 1 2 2 2 1 1 1 1 1 1 1 1 1 
2 1 2 2 2 1 1 1 1 2 2 1 1 1 1 1 1 1 1 1 
2 1 2 2 2 1 1 1 1 1 2 1 1 1 1 1 1 1 1 1 
2 2 2 2 2 1 1 1 1 1 1 1 1 1 1 1 1 1 1 1 
1 1 1 1 1 1 2 1 1 1 1 1 1 1 1 1 1 1 1 1 
1 2 1 1 1 1 1 1 1 1 1 1 1 1 1 1 1 1 1 1 
1 1 1 3 1 1 1 1 1 1 1 1 1 1 1 1 1 1 1 1 
1 2 1 1 3 3 3 1 1 1 1 1 1 1 1 1 1 1 1 1 
1 3 3 3 3 3 3 3 3 1 1 1 1 1 1 1 1 1 1 1 
1 2 1 3 3 3 3 1 3 1 1 1 1 1 1 1 1 1 1 1 
1 1 1 3 3 3 3 1 3 1 1 1 1 1 1 1 1 1 1 1 
1 2 1 1 1 3 1 3 3 1 1 1 1 1 1 1 1 1 1 1 
1 1 1 1 1 1 3 1 3 1 1 1 1 1 1 1 1 1 1 1 
1 2 1 1 1 1 1 3 3 1 1 1 1 1 1 1 1 1 1 1 
1 1 1 1 1 1 3 1 3 1 1 1 1 1 1 1 1 1 1 1 
1 2 1 1 1 1 1 3 3 1 1 1 1 1 1 1 1 1 1 1 
Portals
Map21 6:1 1:1
start 1:1 19:19
