Name File2
FileName MapTestt
Size 19:21
Blocks
1 1 1 1 1 1 1 1 1 1 1 1 1 1 1 1 1 1 1 1 1 
1 2 1 2 1 2 1 2 1 2 1 2 1 2 2 2 2 2 1 2 1 
1 1 1 1 1 1 1 2 1 2 1 2 1 2 1 1 1 2 1 2 1 
1 2 1 2 1 2 1 2 1 2 1 2 1 2 1 2 1 2 1 2 1 
1 1 1 1 1 1 1 2 1 2 1 2 1 2 1 2 1 2 1 2 1 
1 2 2 2 2 2 2 2 1 2 1 2 1 2 1 2 1 2 1 2 1 
1 1 1 1 1 1 1 1 1 2 1 2 1 2 1 2 1 2 1 2 1 
1 2 2 2 2 2 2 2 1 2 1 2 1 2 1 2 1 2 1 2 1 
1 1 1 1 1 1 1 2 1 2 1 2 1 2 1 2 1 2 1 2 1 
1 2 2 2 2 1 1 2 2 2 1 2 1 2 1 2 1 2 1 2 1 
1 1 1 1 2 1 1 1 1 1 1 2 1 2 1 2 1 2 1 2 1 
1 2 2 1 2 2 2 2 2 2 2 2 1 2 1 2 1 2 1 2 1 
1 1 1 1 1 1 1 1 1 1 1 1 2 2 1 2 1 2 1 2 1 
1 2 2 2 2 2 2 2 2 2 2 2 2 2 1 2 1 2 1 2 1 
1 1 1 1 1 1 1 1 1 1 1 1 1 1 2 2 1 1 1 2 1 
1 2 2 2 2 2 2 2 2 2 2 2 2 2 2 2 2 2 2 2 1 
1 1 1 1 1 1 1 1 1 1 1 1 1 1 1 1 1 1 1 2 1 
1 2 2 2 2 1 1 2 2 2 2 1 2 2 2 2 2 1 2 2 1 
1 1 1 1 1 1 1 1 1 1 1 1 1 1 1 1 1 1 1 1 1 
Portals
MapTest x:y x:y